NO  ./texturs/NO.xpm
SO ./texturs/SO.xpm
WE ./texturs/WE.xpm
EA ./texturs/EA.xpm

F 28,109,208
C 49,8,123


        1111111111111111111111111
        1000000000110000000000001
        1011000000010000000000001
        1001000000000000000000001
111111111011000000010000000000001
100000000011000001110111115111111
11110111111111011100000000001
111101111111101111010100000011
1100000011010000000000000000001
100000000000001011000000000011
10000000000000001101010000001
11000001110101011111011110N0111
11110111 1110101 101111010001
11111111 1111111 11111111111