     NO      ./north_texture
SO ./south_texture
WE ./west_texture
EA ./east_texture

F 220,100,0
C 225,30,0


111111111111111
100010000000001
100010000000001
100010000000001
100010000000001
100000000001001
100000000001001
10000N000000001
111111111111111